NO ./path_to_the_north_texture
SO ./path_to_the_south_texture
WE ./path_to_the_west_texture
EA ./path_to_the_east_texture



F 220,110,40
C 225,30,0



        1111111 11111111111111111111   
        1000001 10000110000000000111
        1011001 10001110000000011
        1001001110000000000111001111
11111111101100000111000000111101   
11100000001111100111011111111111
1111011111111 10111111111111111111111
1001011111111111110101001001111
110000001101010111000000S1001111   
10000000000000001100000010001111
10000001111110001101010110001111
110001111111110101011111011110111
111101111  1110101 10111101000011
111111111  11111111 111111111111
