NO ./textures/wall_N.xpm
SO ./textures/wall_S.xpm


WE ./textures/wall_W.xpm  
EA ./textures/wall_E.xpm

F 220,255,40
C 225,30, 85

        1111111 1111111111111111111
        1000001 10000110000000000111  
        1011001 100011100000000111
        1001001110000000000111111  
1111111110110000011100000011111111  
11100000001111100111011111111101
10110111111111011111111111111111     11111111111
10000110101011110000010111111111     1110101101111
10000110101011110000010111111111     1111111111
10000110101011110000010111111111  
1000000000001S0100011000001111111  
100000111111111101010110001111  
11000111111101101111111011110111  
111101111  1110101 1011110110001  
111111111  1111111 1111111111111  
