NO ./path_to_the_north_texture
SO ./path_to_the_south_texture
WE ./path_to_the_west_texture
EA ./path_to_the_east_texture

F 220,110,0
C 225,30,0

        1111111 11111111111111111111   
        1000001 10000110000000000001
        1011001 100011100000000011111
        100100010000000000001111
1111111110110000011100000001   
11100000001100000111011111111111
111101111111110111111111111111111111
100101111111110 1110101001001
11000000110101011100E00001001   
10000000000000001100000010001111
1000000000000001101010110001
110000011101010111110111100111
11110111 1110101 10111101000011
11111111 1111111 111111111111
