NO ./path_to_the_north_texture
SO ./path_to_the_south_texture
WE ./path_to_the_west_texture
EA ./path_to_the_east_texture

F 220,110,0
C 225,30,0

        1111111 11111111111111111111   
        1000001 10000110000000000001
        1011001 100011100000000111111
        10010011100000000001111
1111111110110000011100000001   
11100000001100000111011111111111
111101111111110111111111111111111111
1001011111111101110101001001
1100000011010101110000001001   
10000000000000001100000010001111
1000000000000001101010110001
1100000111010101111101111N0111
11110111 1110101 10111101000011
11111111 1111111 111111111111
